...............
..@............
....#..........
.#........#....
...............
.......#.......
#.............#
...............
#.......#......
.....#.........
............#..