.........
..@......
....#....
.#.......
...#.....
.......#.
#.......#
.........
