##########################
#........................#
#........................#
#........................#
#........................#
#............@...........#
#........................#
#........................#
#........................#
##########################